....................
....................
....................
..x....x....x.......
..x....x....x.......
................x...
...............x....
....x....x....x.....
....................
....................
.s...x....x....x....
....................
....................
.x....x....x....x...
....................
....................
levelName hard - Lvl 005
boosts 3