0.......23........1.
xxxxxxxxxxxxxxxxxxx.
x...x....xx.....xxx.
x.........xx......x.
x.x..x............x.
x..xx...x...xx....x.
x.................x.
x...xx....xxxx....x.
..x...xx..xxx.......
.............xxx....
xx......xxx.....xx..
..xx...........xx...
....xx........xx....
......xx....xx......
levelName easy - Lvl 010
boosts 1