....................
....................
.x.x...x.x..1.x.....
......x....x...x....
.........0..x...x...
.x2..x.......x......
..x...x..x.x.x......
.x.x...x.....x......
..x.x...xxxxx.......
...x.x3.............
....x.x..x.x.x.x....
.....x..........x...
.x....x..x.x.x.x....
................x...
levelName medium - Lvl 007
boosts 2