....................
.................0..
..x......1..........
..............x.....
...........2........
.............x......
...........x..x.....
........xxx.......x.
........xxxx.....x..
.............3..x...
.x.............x....
..............x.....
......x......x....x.
....................
levelName hard - lvl 002
boosts 1