....................
....................
...x...x...x...x....
x...................
.x..................
.0xxxxxxxx1xxxx2....
..........x....x.3..
.xxxx...........x...
.................x..
........x......x....
.xxx...x......x.....
......x......x....x.
.....x......x....x..
.xx.x......x........
...x......x.........
..x......x......x...
.x......x......x....
....................
levelName hard - Lvl 004
boosts 1