....................
....................
..0..x..x..x.1..x...
...............x....
..x...........x.....
...x....x....x......
.............2......
....................
...x....x....x......
..x...........x.....
............3.......
........x...........
...x........x.......
....................
.....xx...xx......x.
....................
levelName hard - Lvl 003
boosts 1