....3...............
....................
.x.x.x......xx..1...
......x.....xx..x...
.......x.x.xxx......
....0.......x....x..
................x...
....x..........x....
....x....x....x...x.
........x.x..x..2x..
.......x...x....x...
.x.............x..x.
.xx..xx..xx..xx..xx.
....................
levelName easy - Lvl 007
boosts 5
time 5.0