.................... 
....................
....................
....................
....................
..0.1.2.............
........3...........
....................
..x.x.x.............
...x.x.x.x..........
..........x..x......
...........xx.......
....................
....................
levelName easy - lvl 003
boosts 4
time 10.0