.0.............1....
....................
.x.x..x...x....x....
...x....x...x..x.x..
.x.x..x...x....x....
..x....x....x..3.x..
.x....x.2.x..x...x..
..............x.x...
.x.x....x.x....x....
....x.............x.
.....x..x...........
.x...x....x.....x.x.
.................x..
....................
levelName easy - Lvl 007
boosts 3
time 10.0