................3...
....................
.......x........x...
....x........2......
....................
..........x.....x...
...x........x..x....
......1.x....xx.....
....................
..x...x.............
.0......xxx.x.......
......x..x..x..x....
.x......xxx.......x.
....................
levelName easy - Lvl 009
boosts 5
time 7.0