0.................1.
x.x.x.x.x.x.x.x.x...
x...x....xx.....xxx.
x.........xx.2....x.
x.x..x............x.
x..xx3..x...xx....x.
x.................x.
x...xx....xxxx....x.
..x...xx..xxx.......
.............xxx....
xx......xxx.....xx..
..xx...........xx...
....xx........xx....
......xx....xx......
levelName easy - Lvl 010
boosts 4
time 10.0