...0...........1....
....................
..xx...x...x...x....
....................
x....x..............
....................
........x...........
x...................
..2........x..3.....
..x.................
x..x..........x.....
.x..x...............
..x..x...x...x...x..
....................
levelName easy - Lvl 007
boosts 5
time 7.0