....................
..0.........3....1..
..x..x......x....x..
.xx...2.........x...
..x...x...x....x....
....................
.......x....x....x..
.x..................
......x...x..x....s.
.s..................
.x..................
..x.................
...x..............x.
....................
levelName easy - Lvl 010
boosts 5
time 7.0