.......3.1...2...... 
.....0..............
.....x..............
....................
.....x...x..........
...................
.....x...x...x......
....................
.....x...x...x......
.....x..............
.....x..............
.....x..............
....................
....................
levelName easy - Lvl 003
boosts 5
time 5.0