....................
.............x..x.x.
............x.xx.x..
...........x....xxx.
..x.....x....3......
......x.............
......x........x....
..x...x......x...x..
......x.............
..x.........2.......
.0..........x.....1.
...........x........
.x........x......xx.
....................
levelName EXTREME - Lvl 002
boosts 3