.0...............1..
....................
.x..................
.................x..
....................
.x..................
.........x.......x..
..................2.
.x..................
.3..................
....................
.x.....x..........x.
.................x..
....................
levelName EXTREM - Lvl 000
boosts 2