....................
....................
.x.xx...x...x....x..
.......x............
......x..........x..
.x.........x...x..x.
................xxx.
......x....x.....x..
.x..............x.x.
...........x.....x..
.................x..
.x.........x....x.x.
.0..x1.x.2....3..x..
...........x....xxx.
levelName EXTREME - Lvl 002
boosts 4