0.................1.
xxxxxxx.......x.x.x.
.......x.2.3.x......
........x...x.......
.........xxx........
x.................x.
....................
....................
....................
.......x..x.........
....................
....................
x.................x.
....................
levelName EXTREME - Lvl 002
boosts 2