......................
......................
.........1............
......................
.....2.......3........
........xxx...........
......................
.....x.......x........
....x.........x.......
......................
.........0............
...x...........x......
....x.........x.......
........xxx...........
......................
......................
levelName medium - Lvl 003 
boosts 3