....................
....................
.....23.............
....................
.....xx.............
....................
...x....x...........
....................
....................
.0xx....xx1.........
....................
....................
.xxx....xxx.....xx..
....................
levelName medium - Lvl 005
boosts 3