....................
.........1....2.....
.x.x...x.x....x.....
......x....x...x....
.........0..x...x...
.x...x.......x......
..x...x..x.x.x..3...
.x.x...x.....x......
..x.x...xxxxx.......
...x.x..............
....x.x..x.x.x.x....
.....x..........x...
......x..x.x.x.x....
................x...
levelName medium - Lvl 007
boosts 3