.0.......1....2..3..
....................
.x.......x....x.....
....................
....................
.x...............x..
.........x..........
....................
.x...............x..
....................
....................
.x.....x..........x.
.................x..
....................
levelName medium - Lvl 008
boosts 4