.....2.......3......
....................
.....x...x...x......
.x..................
....................
....................
.x...x.......x......
...........1........
.................x..
...........x........
...................
...0................
...x...x...x...x....
....................
....................
levelName medium - Lvl 006
boosts 4