.....................
......1......2.......
.0....x.x....x.......
.....................
.....................
.x.....x.....x.......
.............3.......
.....................
.x....x.x....x.......
.....................
.....................
.x...x...x...x.......
.....................
.....................
.....................
.....................
levelName medium - Lvl 004
boosts 3