....................
....................
.xxx....x...x..x....
.0.1....2...3.......
....................
.x..............x...
...x....x...x..x....
................x...
....................
......x..x..x..x..x.
.....x..x..x..x..x..
....x..x..x..x..x...
x..x..x..x..x..x....
....................
levelName medium - Lvl 007
boosts 2