....................
.0........1.........
....................
.......2............
.xxx...x..xxx.......
........x...........
.xxx...x..xxx.......
........3...........
......xxx..........
....................
....................
....................
..x.................
....................
levelName medium - Lvl 002
boosts 1